10 24
MMMM MMMM MMMM MMMM MMMM MMMM MMMM MMMM MMMM MMMM MMMM MMMM MMMM MMMM MMMM MMMM MMMM MMMM MMMM MMMM MMMM MMMM MMMM MMMM
MMMM MMMM MMMM GGGG GGGG GGGG GGGG GGGG GGGG GGGG GGGG GGGG GGGG GGGG GGGG GGGG GGGG GGGG GGGG GGGG GGGG MMMM MMMM MMMM
MMMM GGGG GGGG GGGG GGGG GGGG GGGG GGGG GGGG GGGG GGGG GGGG GGGG GGGG GGGG GGGG GGGG GGGG GGGG GGGG GGGG GGGG MMMM MMMM
MMMM GGGG GGGG GGGG GGGG GGGG GGGG GGGG GGGG GGGG GGGG GGBB GGBB GGBB GGBB GGBB GGBB GGGG GGGG GGGG GGGG GGGG MMMM MMMM
MMMM GGGG GGGG GGGG GGGG GGGG GGGG GGGG GGGG GGBB bbbb bbBB bbBB bbBB bbBB bbBB bbBB bbgg GGGG GGGG GGGG GGGG MMMM MMMM
MMMM GGGG GGGG GGGG GGGG GGGG GGGG GGGG GGGG BBBB bbbb bbBB bbBB bbBB bbBB bbBB bbBB BBBB GGGG GGGG GGGG GGGG MMMM MMMM
MMMM GGGG GGGG GGGG GGGG GGGG GGGG GGGG GGGG GGGG GGGG GGGG bbBB bbBB bbBB bbBB BBBB GGGG GGGG GGGG GGGG GGGG MMMM MMMM
MMMM GGGG GGGG GGGG GGGG GGGG GGGG GGGG GGGG GGGG GGGG GGGG GGGG GGGG GGGG GGGG GGGG GGGG GGGG GGGG GGGG GGGG MMMM MMMM
MMMM MMMM MMMM GGGG GGGG GGGG GGGG GGGG GGGG GGGG GGGG GGGG GGGG GGGG GGGG GGGG GGGG GGGG GGGG GGGG GGGG MMMM MMMM MMMM
MMMM MMMM MMMM MMMM MMMM MMMM MMMM MMMM MMMM MMMM MMMM MMMM MMMM MMMM MMMM MMMM MMMM MMMM MMMM MMMM MMMM MMMM MMMM MMMM
(5,5) Player 0
(3,1) FloorFollowingThief RIGHT G
(7,1) FloorFollowingThief RIGHT G
(11,1) FloorFollowingThief RIGHT G
(15,1) FloorFollowingThief RIGHT G
(17,1) FloorFollowingThief RIGHT G
(3,5) SmartThief
(8,8) Diamond
(17,8) Ruby
(15,5) Diamond
(20,4) Ruby
(20,7) Diamond
(17,7) Exit
180