9 21
GGGG GGGG GGGG GGGG GGGG GGGG GGGG GGGG GGGG GGGG GGGG GGGG GGGG GGGG GGGG GGGG GGGG GGGG GGGG GGGG GGGG
GGGG BBBB BBBB BBBB GGGG YYYY YYYY YYYG GGGG BBBB BBBB BBBB GGGG YYYY YYYY YYYY GGGG BBBB BBBB BBBB GGGG
GGGG BBBB GGGG GGGG GGGG YYYY GGGG GGGG GGGG GGGG GGGG BBBB GGGG GGGG GGGG YYYY GGGG BBBB GGGG BBBB GGGG
GGGG BBBB GGGG GGGG GGGG YYYY GGGG GGGG GGGG GGGG GGGG BBBB GGGG GGGG GGGG YYYY GGGG BBBB GGGG BBBB GGGG
GGGG BBBB GGGG GGGG GGGG YYYY YYYY YYYY GGGG BBBB BBBB BBBB GGGG YYYY YYYY YYYY GGGG BBBB GGGG BBBB GGGG
GGGG BBBB GGGG GGGG GGGG GGGG GGGG YYYY GGGG BBBB GGGG GGGG GGGG GGGG GGGG YYYY GGGG BBBB GGGG BBBB GGGG
GGGG BBBB GGGG GGGG GGGG GGGG GGGG YYYY GGGG BBBB GGGG GGGG GGGG GGGG GGGG YYYY GGGG BBBB GGGG BBBB GGGG
GGGG BBBB BBBB BBBB GGGG YYYY YYYY YYYY GGGG BBBB BBBB BBBB GGGG YYYY YYYY YYYB GGGG BBBB BBBB BBBB GGGG
GGGG GGGG GGGG GGGG GGGG GGGG GGGG GGGG GGGG GGGG GGGG GGGG GGGG GGGG GGGG GGGG GGGG GGGG GGGG GGGG GGGG
(0,0) Player 0
(5,0) Dollar
(7,2) Ruby
(9,1) Diamond
(3,7) Gate blue
(2,7) Gate green
(10,1) Switch blue
(14,7) Switch green
(3,1) Gate green
(2,1) Gate blue
(1,4) Exit
180