9 21
GGGG GGGG GGGG GGGG GGGG GGGG GGGG GGGG GGGG GGGG GGGG GGGG GGGG GGGG GGGG GGGG GGGG GGGG GGGG GGGG GGGG
GGGG BBBB BBBB BBBB GGGG YYYY YYYY YYYG GGGG BBBB BBBB BBBB GGGG YYYY YYYY YYYY GGGG BBBB BBBB BBBB GGGG
GGGG BBBB GGGG GGGG GGGG YYYY GGGG GGGG GGGG GGGG GGGG BBBB GGGG GGGG GGGG YYYY GGGG BBBB GGGG BBBB GGGG
GGGG BBBB GGGG GGGG GGGG YYYY GGGG GGGG GGGG GGGG GGGG BBBB GGGG GGGG GGGG YYYY GGGG BBBB GGGG BBBB GGGG
GGGG BBBB GGGG GGGG GGGG YYYY YYYY YYYY GGGG BBBB BBBB BBBB GGGG YYYY YYYY YYYY GGGG BBBB GGGG BBBB GGGG
GGGG BBBB GGGG GGGG GGGG GGGG GGGG YYYY GGGG BBBB GGGG GGGG GGGG GGGG GGGG YYYY GGGG BBBB GGGG BBBB GGGG
GGGG BBBB GGGG GGGG GGGG GGGG GGGG YYYY GGGG BBBB GGGG GGGG GGGG GGGG GGGG YYYY GGGG BBBB GGGG BBBB GGGG
GGGG BBBB BBBB BBBB GGGG YYYY YYYY YYYY GGGG BBBB BBBB BBBB GGGG YYYY YYYY YYYB GGGG BBBB BBBB BBBB GGGG
GGGG GGGG GGGG GGGG GGGG GGGG GGGG GGGG GGGG GGGG GGGG GGGG GGGG GGGG GGGG GGGG GGGG GGGG GGGG GGGG GGGG
(0,0) Player 0
(3,3) Bomb
(3,4) SmartThief
(0,1) Ruby
(3,0) Clock
(1,1) Gate blue
(0,2) Switch blue
(2,2) Gate green
(2,3) Exit
180