10 14
YYYY CCYM MMMM MMMM MMMM MYMM YYMM YYMM YMMM MMMM MMMM MMMM CCMY YYYY
YYYY MMMM MMMM MMMM MYMM YYYY YYYY YYYY YYYY YMMM MMMM MMMM MMMM YYYY
YYYY MMMM MMMM MYMM YYYY YYYY YYYY YYYY YYYY YYYY YMMM MMMM MMMM YYYY
RRRB MMMM MMMM MYMY YYYY BBBB YYYY YYYY BBBB YYYY YMYM MMMM MMMM RRBR
YYYY MMMM MMMM MYMY YYYY YYYY YYYY YYYY YYYY YYYY YMYM MMMM MMMM YYYY
YYYY MMMM MMMM MYMY YBBY YYYY YYYY YYYY YYYY BYYB YMYM MMMM MMMM YYYY
YYYY MMMM MMMM MMMY YYYY YBBY YYYY YYYY BYYB YYYY MMYM MMMM MMMM YYYY
YYYY MMMM MMMM MMMM MMMY YYYY YYBB YYBB YYYY MMYM MMMM MMMM MMMM YYYY
YYYY CCYY MMMM MMMM MMMM MMMY MMYY MMYY MMYM MMMM MMMM MMMM CCYY YYYY
GGRR CCCC CCCC CCCC CCCC CCCC GMGM MMMM MGMG CCCC CCCC CCCC CCCC GGRR
(0,0) Player 0
(11,9) Exit
(4,5) Cent
(5,6) Cent
(6,7) Cent
(7,7) Cent
(8,6) Cent
(9,5) Cent
(5,3) Ruby
(8,3) Ruby
(4,9) Diamond
(1,5) FloorFollowingThief up m
(3,3) FloorFollowingThief up y
(11,3) FlyingAssassin right
(0,3) Gate green
(13,3) Gate green
(11,6) Switch green
100